111111111111
1000S0000001
110001110011
10001   1001
111111111111